1111111
1000001
1000001
1P00001
1000001
10000E1
1111111