1111111
1000001
1000001
1P00001
1000011
10001E1
1111111