1111111
1000001
1000001
1P00001
1000001
1111E01
1111111