1111111
10C0101
1110101
1P100C1
1010001
1000E01
1111111