1111111
10C0001
1000101
1P001C1
1000111
1111E01
1111111