11
1000000
100110001
100000001
111111111