111111111
100000001
100110001
100000001
111111111